999,999,999,999,999,999,999,999,999,999,999,999,999,999,999,999,999,999,999,999,999,999,999,999,999,999,999,999,999,999,999,999,999,999,999,999,999,999,999,999
999,999,999,999,999,999,999,999,999,999,999,999,999,999,999,999,999,999,999,999,999,999,999,999,999,999,999,999,999,999,999,999,999,999,999,999,999,999,999,999
999,999,999,999,999,999,999,999,999,999,999,999,999,999,999,999,999,999,999,999,999,999,999,999,999,999,999,999,999,999,999,999,999,999,999,999,999,999,999,999
999,999,999,999,999,999,999,999,0,0,0,0,0,0,0,0,0,0,0,0,0,0,0,0,0,0,0,0,0,0,0,0,0,0,0,0,999,999,999,999
999,999,999,999,999,999,999,999,999,999,999,999,999,999,0,999,999,999,999,999,999,999,999,999,999,999,999,0,999,999,999,999,999,999,999,0,999,999,999,999
999,999,999,999,0,999,999,999,999,999,999,999,999,999,0,999,999,999,999,999,999,999,999,999,999,999,999,0,999,999,999,999,999,999,999,0,999,999,999,999
999,999,999,999,0,999,999,999,999,999,999,999,999,999,0,999,999,999,999,999,999,999,999,999,999,999,999,0,999,999,999,999,999,999,999,0,999,999,999,999
999,999,999,999,0,999,999,999,999,999,999,999,999,999,0,999,999,999,999,999,999,999,999,999,999,999,999,0,999,999,999,999,999,999,999,0,999,999,999,999
999,999,999,999,0,999,999,999,999,999,999,999,999,999,0,999,999,999,999,999,999,999,999,999,999,999,999,0,999,999,999,999,999,999,999,0,999,999,999,999
999,999,999,999,0,0,0,0,0,0,0,0,0,0,0,0,0,0,0,0,0,0,0,0,0,0,0,0,0,0,0,0,0,0,0,0,999,999,999,999
999,999,999,999,0,999,999,999,999,999,999,999,999,999,0,999,999,999,999,999,999,999,999,999,999,999,999,0,999,999,999,999,999,999,999,0,999,999,999,999
999,999,999,999,0,999,999,999,999,999,999,999,999,999,0,999,999,999,999,999,999,999,999,999,999,999,999,0,999,999,999,999,999,999,999,0,999,999,999,999
999,999,999,999,0,999,999,999,999,999,999,999,999,999,0,999,999,999,999,999,999,999,999,999,999,999,999,0,999,999,999,999,999,999,999,0,999,999,999,999
999,999,999,999,0,999,999,999,999,999,999,999,999,999,0,999,999,999,999,999,999,999,999,999,999,999,999,0,999,999,999,999,999,999,999,0,999,999,999,999
999,999,999,999,0,999,999,999,999,999,999,999,999,999,0,999,999,999,999,999,999,999,999,999,999,999,999,0,999,999,999,999,999,999,999,999,999,999,999,999
999,999,999,999,0,999,999,999,999,999,999,999,999,999,0,999,999,999,999,999,999,999,999,999,999,999,999,0,999,999,999,999,999,999,999,999,999,999,999,999
999,999,999,999,0,0,0,0,0,0,0,0,0,0,0,0,0,0,0,0,0,0,0,0,0,0,0,0,0,0,0,0,999,999,999,999,999,999,999,999
999,999,999,999,999,999,999,999,999,999,999,999,999,999,999,999,999,999,999,999,999,999,999,999,999,999,999,999,999,999,999,999,999,999,999,999,999,999,999,999
999,999,999,999,999,999,999,999,999,999,999,999,999,999,999,999,999,999,999,999,999,999,999,999,999,999,999,999,999,999,999,999,999,999,999,999,999,999,999,999
999,999,999,999,999,999,999,999,999,999,999,999,999,999,999,999,999,999,999,999,999,999,999,999,999,999,999,999,999,999,999,999,999,999,999,999,999,999,999,999
999,999,999,999,999,999,999,999,999,999,999,999,999,999,999,999,999,999,999,999,999,999,999,999,999,999,999,999,999,999,999,999,999,999,999,999,999,999,999,999
